

1111111111111
1100N00000001
1111101000001
1111111111111
1111111111111